attacking_force: Армия %1с общей силой %2 вторглась в провинцию [%3].
defending_force: В защите находилась армия %1с общей силой %2.
neutral_army: Местные силы
neutral_army_of: местных сил
winner: Победителем в битве оказались [%1].
lead: под предводительством [%1]
moved: в пути
casualties: Потери
raid_spoils: Добыча рейда составила [%1i] золотых.

attack: Атака
defend: Защита
raid: Рейд
sword: Меч
shield: Щит
diplomacy: Дипломатия
cruelty: Жестокость
nobility: Благородство
will: Воля
support: Поддержка

income: Доход
income_heroes: Расходы на героев
income_province: Доход от провинций
income_units: Расходы на войска
cost: Стоимость
squads: %1i отряда %2
turns: ходов

hero_wait: Герой будет занят еще %1i ходов.
not_enought_gold: Не хватает золота.
total_strenght: Общая сила армии составляет [%1i].
total: Итого
predict_fail: Вы проираете битву, если не произойдет чудо.
predict_partial: Вы выиграете битву, если у врага не будет мощного лидера или он не применит выигрышную тактику.
predict_success: Вы выиграете эту битву.

title: Прототип стратегии

end_turn: Закончить ход
newgame: Начать игру
loadgame: Загрузить игру
savegame: Записать игру
exit: Выход

accept: Принять
cancel: Отменить

yes: Да
no: Нет